...##...#.
##..#.#...
.....##...
..........
.##..#....
.##...#..#
#..##.#.#.
...#...#..
#....##..#
.....##..#