..#...#...
....#.....
.##.##.###
..#.##...#
.....####.
##.#......
#####..#..
......##.#
.#..##.#..
..###....#