..#....##.
##..#.###.
###..##...
##..##....
#.####..#.
.#......#.
...#####.#
..###.#.##
.####.##.#
.###....#.