####......
..##...###
##..#.##.#
.##.#.##.#
###...####
##....##.#
##..#.#.#.
.####..#.#
...#.#.#..
.#.......#